NO ./assets/textures/cs_01.xpm
SO ./assets/textures/cs_02.xpm
WE ./assets/textures/cs_03.xpm
EA ./assets/textures/cs_01.xpm

F 200,180,120
C 100,150,200

1111111111111111111111111111111111
1000000000000010000000000000000001
1011111111111010111111111111111101
1000000000000010000000000000000101
1111111111111011111111111111100101
1000000000001000000000000000100101
1011111111101111111111111110100101
1010000000100000000000000010100101
1010111110111111111111100010100101
1010100000000000000000100010100101
1010101111111111111110100010100101
1010101000000000000010100010000001
1010101011111111111010101111111101
1010101000000000000010100000000001
1010111111111111111110111111111101
10000000000000000000000000000000N1
1111111111111111111111111111111111
