NO    ./assets/textures/north.xpm   
SO   ./assets/textures/north.xpm   

F 50   ,10,0

SO   ./assets/textures/north.xpm  

WE    ./assets/textures/west.xpm   


                EA     ./assets/textures/east.xpm  


C 255,255,255

1111111111
1001001101
100101 101
10101 11001
1010010011
110000000S1
11111111111
