NO ./assets/textures/north.xpm
SO ./assets/textures/south.xpm
WE ./assets/textures/west.xpm
EA ./assets/textures/east.xpm

F220,100,0
C225,30,0

111111
100101
101001
1100N1
111111
