NO ./assets/textures/north.xpm
SO ./assets/textures/south.xpm
WE ./assets/textures/west.xpm
EA ./assets/textures/east.xpm

F 20,20,20
C 200,200,200

11111
10N01
10S01
10001
11111
